1111111111111111111111111111111111
10E10001P10C0000000000000000000001
1010010110110000101001C00000010101
1010010011101010001001000000010011
100000000C1000000000000C0000000001
1111111111111111111111111111111111