1111111111111111111111111111111111
1P00C000C0000000C00000000E00000001
1100010100110000101001001000010101
1010011111101010001001010000010011
1000000000100000000000000000000001
1111111111111111111111111111111111