1111111111111111111111111111111111
10E00000P00C0000000000000000000001
1010010100110000101001C00000010101
1010010011101010001001000000010011
100000000C0000000000000C0000000001
1111111111111111111111111111111111