1111111111
100000E011
1P00010001
100010C011
1111111111