1111111111111111111111111111111111
10C10001P00C0000000000000000000001
1100010100110000101001CC1000010101
1010010001101010001001010000010011
100000000C10000000E0000C0000000001
1111111111111111111111111111111111